name Map1
win 2
##############################
#.....................GG....E#
#..........###################
#.................############
#.......######################
##############################