##############################
#.....###.............GG....E#
#..#........##################
#......G.....................#
#..........G.......G.........#
#....####....................#
#....####....................#
#GGGG####....................#
##############################